Абхазия|Abkhazia|Абхазія
Албания|Albania|Албанія
Болгария|Bulgaria|Болгарія
Вьетнам|Vietnam|Viet Nam|Viet-Nam|В'єтнам
Греция|Greece|Греція
Грузия|Georgia|Грузія
Доминикана|Доминиканская Республика|Доминиканcкая Республика|Доминиканская р-ка|Dominican Republic|Домінікана|Домініканська республіка
Египет|Egypt|Єгипет
Израиль|Israel|Ізраїль
Индия|India|Індія|Гоа|Індія
Индонезия|Indonesia|Индонезия (о. Бали)|Бали|Індонезія
Иордания|Jordan|Йорданія
Испания|Spain|Іспанія
Италия|Italy|Італія
Кипр|Северный Кипр|Cyprus|Кіпр
Китай|China
Куба|Cuba|Варадеро
Мальдивы|Maldives|Republic of Maldives|Мальдивские о-ва|Мальдивские острова|Мальдіви
Марокко|Morocco|Морокко
Мексика|Mexico
ОАЭ|UAE|United Arab Emirates|Объединенные Арабские Эмираты|ОАЕ|Об'єднані Арабські Емірати
Россия|Российская Федерация|Russia|Росія
Таиланд|Thailand|Тайланд|Таїланд
Танзания|Tanzania|Танзания (Занзибар)|Танзания (о.Занзибар)|Танзания (о Занзибар)|Танзанія - о Занзібар|Танзанія
Тунис|Tunisia|Туніс
Турция|Turkey|Туреччина|Турция (Кушадасы)
Хорватия|Croatia|Хорватія
Черногория|Montenegro|Чорногорія
Чехия|Czech Republic|Чехія
Шри-Ланка|Sri-Lanka|Шри Ланка|Шрі-ланка|Шрі Ланка